5 5
XXXXX
XS..X
X  .X
X  GX
XXXXX

