15 15
XXXXXXXXXXXXXXX
XS            X
XXXXXXXXXXXXX X
X             X
X XXXXXXXXXXXXX
X             X
XXXXXXXXXXXXX X
X             X
X XXXXXXXXXXXXX
X             X
XXXXXXXXXXXXX X
X             X
X XXXXXXXXXXXXX
X            GX
XXXXXXXXXXXXXXX
